#############
#...........#
#.*.*.*.*.*.#
#...........#
#.*.*.*.*.*.#
#...........#
#############